0,0,0,0,0,0,0,0,0,0,0,0,0,0,0,0
0,0,0,0,0,0,0,0,0,0,0,0,0,0,0,0
0,0,0,0,0,0,0,0,0,0,0,0,0,0,0,0
0,0,0,1,1,1,1,1,1,1,1,1,1,0,0,0
0,0,0,1,0,0,0,0,0,1,1,1,1,0,0,0
0,0,0,1,0,0,1,4,4,1,1,1,1,0,0,0
0,0,0,1,3,0,1,0,0,3,1,1,1,0,0,0
0,0,0,1,0,4,1,0,0,0,3,1,1,0,0,0
0,0,0,1,3,0,1,0,4,4,0,0,1,0,0,0
0,0,0,1,4,0,1,2,1,3,0,0,1,0,0,0
0,0,0,1,0,0,0,0,1,1,0,0,1,0,0,0
0,0,0,1,0,0,0,3,1,1,0,0,1,0,0,0
0,0,0,1,1,1,1,1,1,1,1,1,1,0,0,0
0,0,0,0,0,0,0,0,0,0,0,0,0,0,0,0
0,0,0,0,0,0,0,0,0,0,0,0,0,0,0,0
0,0,0,0,0,0,0,0,0,0,0,0,0,0,0,0
